6 9
#########
#S#...#E#
#.#.#.#.#
#.#.#.#.#
#...#...#
#########