7 8
########
#.##..E#
#.##.###
#.#..###
#.##...#
#S...#.#
########