8 26
##########################
#S#............#....#....#
#.#...###....###.##.#.##E#
#.#.###.#..#...#.##.#.##.#
#.....#...###....#....##.#
###.##..##.#..####.##..###
###..##....####....#######
##########################